-17
16
-9
9
0000000000000000000000000000000000
0000000000000000000000000000000000
0000000000000000000000000000000000
0000000000000000000000000000000000
0000000000000000000000000000000000
0000000111111111111111111110000000
0000000100000000000000000010000000
0000000101110000000000000010000000
0000000101110000000000000010000000
0000000101111100000000000010000000
0000000101111100000000000010000000
0000000100011100000000000010000000
0000000100000000000000000010000000
0000000100000000000000000010000000
0000000100000000000000000010000000
0000000111111111111111111110000000
0000000000000000000000000000000000
0000000000000000000000000000000000
0000000000000000000000000000000000
