-17
16
-9
9
0000000000000000000000000000000000
0000000000000000000000000000000000
0000000000000000000000000000000000
0000000000000000000000000000000000
0000000000000000000000000000000000
0000000000000000000000000000000000
0000000000000000000000000000000000
0000000000000111111111111100000000
0000000000000001111111111100000000
0000000000000001111111111100000000
0000000000000001111111111100000000
0000000000000001111111111100000000
0000000011100001111111111100000000
0000000011111111111111111100000000
0000000011111111111111111100000000
0000000000000000000000000000000000
0000000000000000000000000000000000
0000000000000000000000000000000000
0000000000000000000000000000000000
