-33
36
-10
22
0000000000000000000000000000000000000000000000000000000000000000000000
1111111111111111111111111111111111111111111111111111111111111111111110
1000000000000000000000000000000000000000000000000000000000000000000010
1000000000000000000000000000000000000000000000000000000000000000000010
1000000000000000000000000000000000000000000000000000000000000000000010
1000000011000000000000000000000000000000000000000000000000000000000010
1000000011000000000000000000000000000000000000000000000000000000000010
1000000000000011000000000000000000000000000000000000000000001100000010
1000000000000011000000000000000000000000000000000000000000001100000010
1000000000000000000000000000000011000000000000000000000000000000000010
1000000100000000000000000111110011000000000000000000000000000000000010
1000000100000000000000000100011000000000000000000000000000000000000010
1000000000000111111110000100001100000000000000000000000000000000000010
1000000000000100000011111100000100010000000000000000000000000000000010
1001100000000100000000000000000100000000000000000000000000000000000010
1001100000000100000000000000000100000000000000000000000000000000000010
1000000000000110000000000000000100000000000000000000000000000000000010
1000000000000010000000000000000100000000000000000000000000000000000010
1000000000000110000000000000011100000000000000000000000000000000000010
1000000000000100000000000000010000110000000000000000000000000000000010
1000011000000100000000000010010000110000000000000000000000000000000010
1000011000000100000000000000010000000000000000000000000000000000000010
1000000000000111111111110000010000000000000000000000000000000000000010
1000001100000000000000011111110010000110000000000000000000010000000010
1000001100000000000000000000000000000110000000000000000000000000000010
1000000000000000000000000000000000000000000000000000000000000000000010
1000000000000000000011000000110000000000000000000000000000000000000010
1000000000000000000011000000110000000000000000000000000000000000000010
1000000000001100000000000000000000000000000000000000000000000000000010
1000000000001100000010000000000000000000000000000000000000000000000010
1000000000000000000000000010000000000000000000000000000000000000000010
1000000000000000000000000000000000000000000000000000000000000000000010
1111111111111111111111111111111111111111111111111111111111111111111110
