-33
36
-10
22
0000000000000000000000000000000000000000000000000000000000000000000000
0000000000000000000000000000000000000000000000000000000000000000000000
0111111111111111111111111111111111111111111111111111111000000000000000
0111111111111111111111111111111111111111111111111111111000000000000000
0111110111111111011111111111111111111111111111111111111000000000000000
0111111100111111111101111111111111111111111111111111111000000000000000
0111111100111111111111111111111111111111111111111111111000000000000000
0111011111111100111111111111111111110011111111111110111000000000000000
0111111111111100111111111111111111111111111111111111111000000000000000
0111111111001111101111110000000000111111111111111111111000000000000000
0111111011001111111111110111111000111111111111111111111000000000000000
0111111011110000000000110111111001111111111111111111111000000000000000
0111111111110111111110000111111101111111111101111111111000000000000000
0111101111110111111111111111111101101111111111111111111000000000000000
0110011111110111111111111111111101111111111111111111111000000000000000
0110011111110111111111111111111101111111111111111111111000000000000000
0111111111110111111111111111111101111111111111111111111000000000000000
0111111111110011111111111111111101111111111111111111111000000000000000
0111011101110111111111111111111100111111111101111111111000000000000000
0111111111110111111111111111110000001111111111111111111000000000000000
0110100111110111111111111111110111001111111111111111111000000000000000
0111100111110111111111111111110111111111111111111111111000000000000000
0111111111110111111111111111110111111111111111111111111000000000000000
0111110011010000000000011111110111111001111111111111111000000000000000
0111110011111111111111000000000111011001111111111111111000000000000000
0111111111111111111111111111111111011111111111111101111000000000000000
0111110111111111111100111111001111111111111111111111111000000000000000
0111111111110111111100110111001111111111111111011111111000000000000000
0111111111110010111111111111111110111111111111111111111000000000000000
0111111111110011111101111111111111111111111111111111111000000000000000
0111111111111111111111111101111011111111111111111111111000000000000000
0111111111111111111111111111111111111111111111111111111000000000000000
0000000000000000000000000000000000000000000000000000000000000000000000
